NO textures/wall_00.xpm
SO textures/wall_01.xpm
WE textures/wall_02.xpm
EA textures/wall_04.xpm
F 72,78,78
C 91,188,199
        1111111111111111111111111
        1000000000110000000000001
        1011000001110000000000001
        1001000000000000000000001
111111111011000001110M00000000001
100000000011000001110111110111111
11110111111111011100000010001
11110111111111011101010010001
1100000011M101011100000010001
10000000000000001100000010001
10000000000000001101010010001
11000001110101011111011110N0111
11110111 1010101 10111101M001
11111111 10111111 111111111111111111
10000011 101M00011000000000000000001
10000001 100000010010000000010000001
10000001 100000010010000000M100000001
10000001110000001001111111111111111111
10000000100000011000000000000000000001
100000000000000M1111111111111111111001
1M000000000000000000000000000000000001
11111111111111111111111111111111111111
