NO textures/wall_00.xpm
SO textures/wall_01.xpm
WE textures/wall_02.xpm
EA textures/wall_04.xpm
F 72,10,78
C 91,188,199
        1111111111111111111111111
        1000000000110000000000001
        1011000001110000000000001
        1001000000000M00E00000001
111111111011000001110000000000001
100000000011000001110111110111111
11110111111111011100000010001
11110111111111011101010010001
11000000110101011100000010001
10000000100000001100000010001
11111111 11101111111111111111
11111111111111111111111111111 
10000000000000001101010010001
1100000111010101111101111010111
11110111 1110101 101111010001
11111111 1111111 111111111111
